"Date","Description","Withdrawls","Deposits","Balance","Memo"
"2020/09/27","クレジットカード","1,091",,"73,744","-"
"2020/09/26","定期預金","10,000",,"74,835","-"
"2020/09/25","給与 BAR",,"4,021","84,835","-"
"2020/09/09","口座振替 bar","2,594",,"80,814","-"
"2020/09/07","振込 foo","3,266",,"83,408","-"
"2020/09/04","振込 FOO",,"600","86,674","-"
